10 8
1111111111
1200101001
1000000011
1110101111
1100100103
1101111101
1000000001
1111111111